S,S,G,G,G,G,G,G,G,S,S,S,S,S,S,S,S,S,S,S,S,S,S,S,S
G,G,G,G,G,G,G,G,G,S,S,S,S,S,S,S,S,S,S,S,S,S,S,S,S
G,G,G,G,G,S,S,S,S,S,S,S,S,S,L,L,S,C,C,C,C,C,S,S,S
G,G,G,G,S,S,S,S,S,S,S,S,S,L,L,S,L,C,C,C,C,C,C,S,S
S,S,S,S,S,S,S,S,S,S,S,C,C,L,S,L,C,C,F,F,F,C,C,S,S
S,S,S,S,S,S,S,S,S,S,S,C,C,S,S,L,C,C,F,F,F,F,L,S,S
S,S,S,S,S,S,S,S,S,S,S,S,S,L,L,L,L,F,F,F,F,F,L,S,S
S,S,C,C,L,L,L,L,L,S,S,S,S,S,S,L,L,L,F,F,F,F,L,S,S
S,C,C,C,C,C,C,C,C,L,S,S,S,L,S,L,L,L,F,F,F,F,S,S,S
S,C,C,C,C,C,C,C,C,L,L,L,S,S,S,S,S,S,S,S,S,S,S,S,S
S,C,C,C,C,C,C,C,C,F,F,L,S,S,S,S,S,S,S,S,S,S,S,S,S
S,F,F,F,F,F,F,L,L,F,F,L,S,S,S,S,S,S,S,S,G,G,G,G,G
S,F,F,F,F,F,F,C,C,C,C,L,S,S,S,S,S,S,S,G,G,G,G,G,G
S,F,F,F,F,F,F,C,C,C,C,S,S,S,S,S,S,S,S,G,G,G,G,G,G
S,S,F,F,F,F,S,S,S,S,S,S,S,S,S,S,S,S,S,G,G,G,G,G,S
