S,S,G,G,G,G,G,S,S,S,S,L,F,S,C,C,S,S
G,G,G,G,G,G,G,S,S,S,L,F,S,F,C,C,C,C
G,G,G,G,G,S,S,S,F,F,L,S,S,C,F,F,F,F
G,G,G,G,S,S,S,C,C,C,S,S,L,F,F,F,F,F
S,S,G,G,S,S,S,S,F,F,L,L,C,C,L,F,F,F
S,S,S,S,S,S,S,S,S,S,S,S,F,F,L,F,F,S
S,S,S,S,S,S,S,S,S,S,L,S,F,L,L,F,C,C
S,S,S,S,S,S,S,S,S,S,F,F,F,F,S,F,F,S
S,S,S,S,S,S,S,S,S,S,S,S,S,S,S,F,F,S
S,S,C,C,F,L,L,F,F,S,S,S,S,S,F,F,S,S
S,S,C,F,F,F,F,F,F,F,S,S,S,S,F,L,S,S
S,S,L,C,F,F,F,F,F,F,F,L,S,S,S,S,S,S
S,S,S,C,C,F,F,L,L,F,F,F,S,S,S,S,S,S
S,S,F,F,F,C,C,L,L,F,F,L,S,S,S,G,G,G
S,F,F,F,F,F,F,F,L,C,C,L,S,S,G,G,G,G
S,C,C,F,F,F,F,C,C,C,C,S,S,G,G,G,G,G
S,S,F,F,F,F,S,S,S,S,S,S,S,S,S,G,G,G
